Thomas	Lawrence
Sally	Duncan
Leah	Carr
Felicity	Ferguson
Edward	Peake
William	Wilson
Ian	Sutherland
Heather	Cameron
Grace	Bower
Bernadette	Thomson
Joanne	Sharp
Hannah	Hodges
Wendy	Watson
Connor	Knox
Frank	Edmunds
Bernadette	Hardacre
William	Springer
Faith	Kelly
Liam	Vaughan
Jake	Jackson
Dominic	Buckland
Tracey	Lyman
Joshua	Tucker
Angela	Gray
Jason	Howard
Carol	Bailey
Kevin	Ball
Melanie	Lee
Felicity	Murray
Robert	Hart
Dorothy	Graham
Dan	Taylor
Diane	Gray
Sean	Simpson
Dorothy	Roberts
Jane Watson
Ryan Rees
Sebastian Skinner
Peter MacDonald
Nathan Stewart
Amelia Underwood
Gordon Hamilton
Anna Bond
Samantha Wright
Isaac Churchill
Katherine Anderson
Liam Short
Stephanie Murray
Harry Mathis
Andrew Stewart
Neil White
Andrea Wilson
Dan	Ellison
Grace	MacLeod
David	Gill
Colin	Lawrence
Yvonne	Burgess
Anthony	Gibson
Elizabeth	Simpson
Caroline	Burgess
Justin	Reid
Kimberly	Cameron
Luke	Bell
Max	Greene
Gordon	Morrison
Tracey	Dickens
Dan	Ball
Eric	Short
Alexander	Henderson
Deirdre	Glover
Jason	Bower
Abigail	Alsop
Frank	Morrison
Sebastian	Poole
Lucas	Lambert
Steven	Clark
Julian	Young
Joe	Kelly
Zoe	Randall
Rachel	Parsons
Piers	Bower
Sarah	Roberts
Andrea	Metcalfe
Charles	Nolan
Boris	North
Andrew	Ogden
Matt	Howard
Ella	Churchill
Oliver	Nolan
Hannah	Wilkins
Emma	Churchill
David	Wilkins
Gabrielle	McDonald
Robert	Ball
Thomas	May
Julia	Burgess
Piers	Taylor
Faith	Terry
Lauren	Jones
Amy	Peters